6 9
111111111
100000001
111I11101
1000001F1
111010001
111111111